#################-----###########
#				#
#############			#	
#	    #         ###########
#	    #			#
#	  ###			#
#	  #			#
#	  #########		#
#		  #		#
#		  #		#
#	###########		#
#				#
#				#
#################################