###############-######
#		     #
#############	     #	
#	    #        #
#	    #	     #
#	  ###	     #
#	  #	     #
#	  #######    #
#		#    #
#		#    #
#	#########    #
#	             #
#		     #
######################